30
WWWWWWWWWWWWWWWWWWWWWWWWWWWWWW
WEEEEEEEEEEEEEEEEEEEEEEEEEEEEW
WESEEEEEEEEEEEEEEEEEEEEEEEESEW
WEEEEEEEWEEEEEEEEEEEWEEEEEEEEW
WEEEEEEEWEEEEEEEEEEEWEEEEEEEEW
WEEEEBEEWEEEEEWEEEEEWEEBEEEEEW
WEEEEEEEWEEEEEEEEEEEWEEEEEEEEW
WEEEEEEEWEEEEEEEEEEEWEEEEEEEEW
WEEWWWWWWEEEEEEEEEEEWWWWWWWEEW
WEEEEEEEEEEEEEEEEEEEEEEEEEEEEW
WEEEEEEEEEEEEEEEEEEEEEEEEEEEEW
WEEEEBEEEWWWWWWWWWWWEEEBEEEEEW
WEEEEEEEEEEEEEEEEEEEEEEEEEEEEW
WEEEEWEEEEEEEEEEEEEEEEEWEEEEEW
WESEEEEEEEEEEESEEEEEEEEEEEESEW
WEEEEWEEEEEEEEEEEEEEEEEWEEEEEW
WEEEEEEEEEEEEEEEEEEEEEEEEEEEEW
WEEEEBEEEWWWWWWWWWWWEEEBEEEEEW
WEEEEEEEEEEEEEEEEEEEEEEEEEEEEW
WEEEEEEEEEEEEEEEEEEEEEEEEEEEEW
WEEWWWWWWEEEEEEEEEEEWWWWWWWEEW
WEEEEEEEWEEEEEEEEEEEWEEEEEEEEW
WEEEEEEEWEEEEEEEEEEEWEEEEEEEEW
WEEEEBEEWEEEEEEWEEEEWEEBEEEEEW
WEEEEEEEWEEEEEEEEEEEWEEEEEEEEW
WEEEEEEEWEEEEEEEEEEEWEEEEEEEEW
WEEEEEEEWEEEEEEEEEEEWEEEEEEEEW
WESEEEEEEEEEEEEEEEEEEEEEEEESEW
WEEEEEEEEEEEEEEEEEEEEEEEEEEEEW
WWWWWWWWWWWWWWWWWWWWWWWWWWWWWW